0000000000000000
2111100111100000
0000100100100000
0000100100100000
0000111100100000
0000000000100000
0000000000100000
0000000000111113
0000000000000000
