0000000000000000
2111100111000000
0000100101000000
0000100101000000
0000111101000000
0000000001000000
0000000001000000
0000000001111113
0000000000000000
