0000011111000000
2100010001000000
0100011101000000
0100000101000000
0100111101000000
0111100001000000
0000001111000000
0000001000011113
0000001111110000
