0000001110000000
0000001011000000
0000001101000000
0000000101000000
0111101101000000
0100101001000000
0100101001000000
2100111001111113
0000000000000000
