0000000000000000
3111111110000000
0000000010011110
0000000010010010
0111100011110010
0100100000000010
0100100000000010
2100111111111110
0000000000000000
