0000000000000000
4111100111000000
0000100101000000
0000100101000000
0000111101000000
0000000001000000
0000000001000000
0000000001111115
0000000000000000
