000000000000000
000000001110000
000000001011000
411111101001115
000001101000000
000001001001000
000001111000000
000000000000000