0000000000000000
2100001111000000
0100001001000000
0100001001000000
0100111001000000
0111100001000000
0000000001000000
0000000001111113
0000000000000000
